20 15 6
XXXXXXXXXXXXXXXXXXXX  
X..................X
X...GG.....GG......X
X..................X
X..................X
X..................X
X..................X
XXXXXXXXXXXXXXJXXXXX 
X.............J....X
X...........J......X
X.J............M...X
X..................X
X..................X
XXXXXXXXXXXXXXXXXXXX 




    
