.....XXXXX
XXXXXX...X
X.....J..X
X..MXXX.XX
XXGJGJG.GX
.X.JX....X
.X..XXXXXX
.X..X.....
.XXXX.....
